0000000000000000000000000000000000000000000000000000000000000000
0000000000000000000000000000000000000000000000000000000000000000
0000000000000000000000000000000000000000000000000000000000000000
0000000000000000000000000000000000000000000000000000000000000000
0000000000000000000000000000000000000000000000000000000000000000
0000000000000000000000000000000000000000000000000000000000000000
0000000000000000000000000000000000000000000000000000000000000000
0000000000000000000000000000000000000000000000000000000000000000
0000000000000000000000000000000000000000000000000000000000000000
1111111111111111111110000000000000000000000000000000000000000000
1111111111111111111110000000000000000000000000000000000000000000
0000000000011000000110000000000000000000000000000000000000000000
0000000000011000000110000000000000000001111111111111111110000000
0000000000011000000110000000000000000111111111111111111111100000
0000000000000000000110000000000000000001111111111111111110000000
0000000000000000000110000000000000000000000000000000000000000000
0000000000000000000110000000000000000000000000000000000000000000
0000000000000000000110000000000000000000000000000000000000000000
0000000000000000000110000000000000000000000000000000000000000000
0000000000000000000110000000000000000000000000000000000000000000
0000000000001111111110000000000000000000000000000000000000000000
0000000000001000000000000000000000000000000000000000000000000000
0000000000001000000000000000000000000000000000000000000000000000
0000000010001000000000000000000000000000000000000000000000000000
0000000010011000000000000000000000000000000000000000000000000000
0000000010011000000000000000000000000000000000000000000000000000
0000000011111000000000000000000000000000000000000000000000000000
0000000011111000000000000000000000000000000000000000000000000000
0000000000011000000000000000000000000000000000000000000000000000
0000000000001000000000000000000000000000000000000000000000000000
0000000000001000000000000000000000000000000000000000000000000000
0000000000001000000000000000000000000000000000000000000000000000
0000000000000000000000000000000000000000000000000000000000000000
0000000000000000000000000000000000000000000000000000000000000000
0000000000000000000000000000000000000000000000000000000000000000
0000000000000000000000001111111111111111100000000000000000000000
0000000000000000000000000000111111111000000000000000100000000000
0000000000000000000000000000000000000000000000000000100000000000
0000000000000000000000000000000000000000000000000001100000000000
0000000000000000000000000000000000000000000000000001100000000000
0000000000000000000000000000000000000000000000000001100000000000
0000000000000000000000000000000000000000000000000001100000000000
0000000000000000000000000000000000000000000000000001100000000000
0000000000000000000000000000000000000000000000000001111000000000
0000000000000000000000000000000000000000000000000001111000000000
0000000000000000000000000000000000000000000000000001111000000000
0000000000000000000000000000000000000000000000000001100000000000
0000000000000000000000000000000000000000000000000001100000000000
0000000000000000000000000000000011110000000000000001100000000000
0000000000000000000000000000000011110000000000000001100000000000
0000000000000000000000000000000011110000000000000001100000000000
0000000000000011111111111111000000000000011111111111100000000000
0000000000000011111111111111000000000000011000000000000000000000
0000000000000000000000000000000000000000011000000000000000000000
0000000000000000000000000000000000000000011000000000000000000000
0000000000000000000000000000000000000000011000000000000000000000
0000000000000000000000000000000000000000011000000000000000000000
0000000000000000000000000000000000000000000000000000000000000000
0000000000000000000000000000000000000000000000000000000000000000
0000000000000000000000000000000000000000000000000000000000000000
0000000000000000000000000000000000000000000000000000000000000000
0000000000000000000000000000000000000000000000000000000000000000
0000000000000000000000000000000000000000000000000000000000000000
0000000000000000000000000000000000000000000000000000000000000000
