0000000111111111111111111111111111111111111111111111111111000000
0000000100000010000000111111111111111100000001111100000001000000
0000000100000010000000100000000000000100000001111100000001000000
0000000100000010000000100000000000000100000001000000000001000000
0000000100000010000000100000000000000100000001000000000001000000
0000000000000010000000000000000000000100000001000000000001000000
0000000000000010000000000000000000000100000001000000000000000000
0000000000000010000000000000000000000000000001000000000000000000
0000000000000010000000000000000000000000000001000000000000000000
0000000000000000000000100000000000000000000001000000000000000000
0000000000000000000000100000000000000000000001000000000000000000
0000000000000000000000100000000000000000000001000000000000000000
0000000100000000000000100000000000000000000001000000000001000000
0000000100000000000000100000000000000000000000000000000001000000
0000000100000010000000100000000000000000000000000000000001000000
0000000100000010000000100000000000000000000000000000000001000000
0000000100000010000000100000000000000100000000000000000001000000
0000000100000010000000000000000000000100000001000000000001000000
0000000100000010000000000000000000000100000001000000000001000000
0000000100000010000000000000000000000100000001000000000001000000
0000000100000010000000100000000000000100000001000000000001000000
0000000100000010000000100000000000000100000001000000000001000000
0000000100000010000000111111111111111100000001000000000001000000
1111111111111111111111111111111111111111111111111111111111111111
0000000000000000000000000000000100000000000000000000000000000000
0000000000000000000000000000000100000000000000000000000000000000
0000000000000000000000000000000100000000000000000000000000000000
0000000000000000000000000000000100000000000000000000000000000000
0000000000000000000000000000000100000000000000000000000000000000
0000000000000000000000000000001110000000000000000000000000000000
0000000000000000000000000000001110000000000000000000000000000000
0000000000000000000000000000011111000000000000000000000000000000
0000000000000000000000000000000000000000000000000000000000000000
0000000000000000000000000000011111000000000000000000000000000000
0000000000000000000000000000001110000000000000000000000000000000
0000000000000000000000000000001110000000000000000000000000000000
0000000000000000000000000000000000000000000000000000000000000000
0000000000000000000000000000000000000000000000000000000000000000
0000000000000000000000000000000000000000000000000000000000000000
0000000000000000000000000000000000000000000000000000000000000000
0000000000000000000000000000000000000000000000000000000000000000
0000000000000000000000000000000000000000000000000000000000000000
0000000000000000000000000000000000000000000000000000000000000000
0000000000000000000000000000000000000000000000000000000000000000
0000000000000000000000000000000000000000000000000000000000000000
0000000000000000000000000000000000000000000000000000000000000000
0000000000000000000000000000000000000000000000000000000000000000
0000000000000000000000000000000000000000000000000000000000000000
0000000000000000000000000000000000000000000000000000000000000000
0000000001100000000000000000000000000000000000000000000000111000
0000000001100000000000000000000000000000000000000000001100111000
0000111000000000000000000000000000000000000000000000001100111000
0000111000000000111000000000000000000000000000000000000000000000
0000111000000000111000000000000000000000000000000000000000000000
0000000000000000111000000000000000000000000000000011110000000000
0000000000000000111000000000000000000000000000000011110000000000
0000000000001100000000000000000000000000000000000011110000000000
0000000000001100000000000000000000000000000000000011110000000000
0000000000000000000000000000000000000000000000000000000000000000
0000000000000000000000000000000000000000000011100000000000000000
0000000000000000000000000000000000000000000011100000000000000000
0000000000000000000000000000000000000000000011100000000000000000
0000000000000000000000000000000000000000000000000000000000000000
0000000000000000000000000000000000000000000000000000000000000000
