0000000000000000000000000000000000000000000000000000000000000000
0000000000000000000000000000000000000000000000000000000000000000
0000000000000000000000000000000000000000000000000000000000000000
0000000000000000000000000000000000000000000000000000000000000000
0000000000000000000000000000000000000000000000000000000000000000
0000000000000000000000000000000000000000000000000000000000000000
1111111111111111111111111111111111111111111111111111110000000001
1000000000000000000000000000000000000000000000000000010000000001
1000000000000000000000000000000000000000000000000000010000000001
1000000000000000000000000000000000000000000000000000010000000001
1000000000000000000000000000000000000000000000000000010000000001
1000000000000000000000000000000000000000000000000000010000000001
1000000000000000000000000000000000000000000000000000010000000001
1000000000000000000000000000000000000000000000000000010000000001
1000000000000000000000000000000000000000000000000000010000000001
1000000000000000000000000000000000000000000000000000010000000001
1000000000000000000000000000000000000000000000000000010000000001
1000000000000000000000000000000000000000000000000000010000000001
1000000000000001111111111111111111111111100000000000010000000001
1000000000000001000000000000000000000000100000000000010000000001
1000000000000001000000000000000000000000100000000000010000000001
1000000000000001000000000000000000000000100000000000010000000001
1000000000000001000000000000000000000000100000000000010000000001
1000000000000001000000000000000000000000100000000000010000000001
1000000000000001000000000000000000000000100000000000010000000001
1000000000000001000000000000000000000000100000000000010000000001
1000000000000001000000000000000000000000100000000000010000000001
1000000000000001000000000000000000000000100000000000010000000001
1000000000000001000000001111111100000000100000000000010000000001
1000000000000001000000001000000000000000100000000000010000000001
1000000000000001000000001000000000000000100000000000010000000001
1000000000000001000000001000000000000000100000000000010000000001
1000000000000001000000001000000000000000100000000000010000000001
1000000000000001000000001000000000000000100000000000010000000001
1000000000000001000000001000000000000000100000000000010000000001
1000000000000001000000001000000000000000100000000000010000000001
1000000000000001000000001000000000000000100000000000010000000001
1000000000000001000000001111111111111111100000000000010000000001
1000000000000001000000000000000000000000000000000000010000000001
1000000000000001000000000000000000000000000000000000010000000001
1000000000000001000000000000000000000000000000000000010000000001
1000000000000001000000000000000000000000000000000000010000000001
1000000000000001000000000000000000000000000000000000010000000001
1000000000000001000000000000000000000000000000000000010000000001
1000000000000001000000000000000000000000000000000000010000000001
1000000000000001000000000000000000000000000000000000010000000001
1000000000000001000000000000000000000000000000000000010000000001
1000000000000001000000000000000000000000000000000000010000000001
1000000000000001111111111111111111111111111111111111110000000001
1000000000000000000000000000000000000000000000000000000000000001
1000000000000000000000000000000000000000000000000000000000000001
1000000000000000000000000000000000000000000000000000000000000001
1000000000000000000000000000000000000000000000000000000000000001
1000000000000000000000000000000000000000000000000000000000000001
1000000000000000000000000000000000000000000000000000000000000001
1000000000000000000000000000000000000000000000000000000000000001
1000000000000000000000000000000000000000000000000000000000000001
1000000000000000000000000000000000000000000000000000000000000001
1000000000000000000000000000000000000000000000000000000000000001
1000000000000000000000000000000000000000000000000000000000000001
1000000000000000000000000000000000000000000000000000000000000001
1000000000000000000000000000000000000000000000000000000000000001
1000000000000000000000000000000000000000000000000000000000000001
1111111111111111111111111111111111111111111111111111111111111111
